1111111111111111111111111111111111111111111111111111111111
1000000000000000000000000000000000000000000000000000000001
1010000100100000000000000000000000000000000000000000000001
10100E0010100000000000000000000000000000000000000000000001
1P0000000C000000000000000000000000000000000000000000000001
1111111111111111111111111111111111111111111111111111111111