1111111111111
1E0000C00C001
1010010100101
1010010010101
1P0000000C001
1111111111111