1111111111111
1000000000001
1010000100101
10100E0010101
1P0000000C001
1111111111111