1111111111111
1E10000000001
1110010100101
1010010010101
1P0000000C001
1111111111111