1111111111
2222222222
1122112211
2222111222