1111111111111111111111111111111111111
0000000000000000000000000000000000000
00000000ECP00000000000000000000000000
0000000000000000000000000000000000000
0000000000000000000000000000000000000
1111111111111111111111111111111111111