1111111111111111111111111111111111111
100000000000000000000000000000000000a
10000000ECP0000000000000000000000000b
100000000000000000000000000000000000c
100000000000000000000000000000000000d
1111111111111111111111111111111111111