1111111111111
1E10000000001
1010010100101
1010010011111
1P0000001C101
1111111111111