1111111111111
1E00000000001
1000010100101
1110010010101
1P1000000C001
1111111111111