111111111111111111111111111111
100001000000000000000000100001
10000000P000000000000000100001
1C0000010000000000000000100E01
111111111111111111111111111111
