1111111111
1ECP222222
11221122CC
2222111222