111111111a
222222222b
333333333c
444444444d